1111111111111111111
1000000000000E00001
10PC0000000C0000001
1000000111111111111
1000000100000000001
1000C00100000000001
1111111111111111111