11111111111
1C0000CPE01
11111111111
