1111111111111111111
1000000000000000001
10PCE00000000000001
1000000011111111111
1000000100000000001
1000000100000000001
1111111111111111111