1111111111111111111
1000000000000000001
100000000000000C001
1000000011111111111
10000001C000000E001
1000000100000000001
1111111111111111111