1111111111111111111
1000000000000000001
10P000000000000C001
1000000000010000001
10000000C000000E001
1000000000000000001
1111111111111111111